#############################################################################################################################################
#..OOOOO#OOO#..OOOOO#.#OOOOOOOOOOOOOOOOOOOOOOO#OOOOOOO#...#...#...#OOOOOOOOOOOOOOO#.#..OOOOOOOOOOOOOOOOOOO#.......#.......#.......#...#....O#
#.#O###O#O#O###O###O#.#O###O#################O#O###O#O#.#.#.#.#.#.#O#######.#####O#.#.#O###.###.#####.#O#O#.#.#####.#.#####.#.###.#.#.#.###O#
#.#O#.#O#O#OOOOO#.#OOOOOOOOOOOOOOOOOOOOOOOOO#O#O..#O#O#.....#...#..OOOOO..#.#..OOO#...#O#.#...#.#.#...#O#OOO#.#...#.#.#.....#.#.#.#.#.....#O#
###O#.#O#O#####.#.#.#.#####.#####.#.###.#.#O#O#O###O#O#####.###########O###.###O#######O#.###.#.#.#.###O#O#O#.#.#.#.#.#.#####.#.#.#########O#
#OOO#.#OOO#.....#...#.#.....#.....#...#.#.#O#OOO#OOO#OOOOO#...#...#....O..#...#OOOOOOOOO#...#.#.#.....#OOOOOOO................#.#.........#O#
#O###.#####.#####.###.#.###.#.###.#.#.#.#.#O#####O#######O#.###.#.#.###O#.###.###########.###.#.#####.###O#O#O#######.#.###.###.#########.#O#
#O..#...#.......#...#...#...#.#.....#.#.#.#OOOOOOO#.....#OOO#...#.#.#..O#...#.....#...#.....#.#.....#.#..O#O#O#.....#...#...#.....#.....#.#O#
#O#.#.#.#.#####.###.#.###.#.#.#####.#.###.###.#########.###O#.###.#.#.#O###.#####.###.#.###.#.#####.#.#.#O#O#O#.###.#.###.###.###.#.###.#.#O#
#O#.#.#.#.#...#.....#...#.#.#.#...#.#.#...#...#.......#...#O#.#.....#..O..#.......#...#...#...#.....#.#.#OOOOO#.#.#.#.#...#...#...#.#.#...#O#
#O#.###.#.#.#######.#####.#.#.#.#.#.#.#.###.###.#####.#.#.#O#.#########O#.#########.#####.#####.#####.#####O#O#.#.#.#.#.###.#.#####.#.#####O#
#O#...#...#.#.....#.....#.#.#...#.#.#.#...#...#.#...#.#.#.#O..#...#...#O..#.......#.....#.#.....#...#...#..O.O..#...#.#.#...#...#...#OOO#OOO#
#O###.#.###.#.###.#####.#.#.#####.###.###.###.#.###.#.#.###O#.#.#.#.#.#O#.#.#####.#####.#.#.###.#.#####.#.#O#O###.#####.###.###.#.###O#O#O#.#
#O..#.#.....#...#...#...#.#.#...#...#...#.#...#...#.#.#.#..OOOOOOOOOOOOO................#.#.#.#.#.........#OOOOOOOOOOOOOOOOOOOOOOOOOOO#OOO#.#
#O###.#####.#.#####.#.###.#.#.#.###.#.#.#.#######.#.#.#.#.#####.#.#.###.#####.###.#.#.###.#.#.#.#.#########.#.#######.#.#.#################.#
#O#...#.....#.#.....#...#.#.#.#...#...#.#...#.....#.#.#...#.....#.#.....#...#.#.....#.#...#...#.#.#.......#.........#.#.#.#.......#.....#...#
#O#.###.#####.#.#.#####.#.#.#.#.#######.###.#.#####.#.#####.#.###.#####.#.#.#.#.#######.#######.#.#.#####.#####.#####.###.#.#####.#.#.###.###
#O#...#...#...#.#.#...#...#.#.#.#.......#.#.#.#.....#...........#.#.......#.#...#.....#.#.......#.#.....#.#.....#.......#.#.#...#.#.........#
#O###.#####.###.###.#.#######.#.#.#####.#.#.#.###.###########.###.#.###.#.#.#####.#.#.#.#.#.###########.#.#.#.###.#####.#.#.#.###.#.#.#.###.#
#O#.#.......#.#.#...#.....#...#.#.#...#...#.#...#...#.....#...#.....#.....#.#.....#.#...#.#.#.............#.#.#...#...#.#.#.#.#...#.#.#...#.#
#O#.#########.#.#.#######.#.###.#.#.#.###.#.###.###.#.###.#.###.###.#.#####.#.#.###.#####.#.#.###########.#.#.#.###.#.#.#.#.#.#.###.#.###.#.#
#OOO#.............#.....#.#...#...#.#...#.#...#.....#.#...#...#.#...#.#.....#...#.......#.#.#...#.....#...#.........#.#...#...#.#.......#.#.#
###O#.###.#.#.#####.#.###.###.#####.#.#.#####.###.###.#.#.###.#.###.#.#.#######.#####.#.###.###.#####.#.#########.#.#.#######.#.###.#.###.#.#
#.#OOOOOOOOOOO....#.#.#.....#.#...#.#.......#.....#...#.....#.#...#.#.#.......#.......#...#...#.......#...........#.#.#.......#.....#.....#.#
#.#.#.#.#.###O###.###.#.###.#.#.#.#.#######.#.#####.#######.#####.#.#.#######.###########.#.#.#######.###########.#.#.#.###########.#.#.###.#
#...#.#.#....O#.#...#.#...#.#...#.#...#...#.#.....#.....#.#.#.....#.#.......#...#.......#.#.#.#.....#.......#...#...#...#.........#...#...#.#
#.#####.#####O#.###.#.###.#####.#####.#.###.#.#.#.#####.#.#.#.#####.###.#.#.###.#.#####.#.#.#.#####.#####.#.#.#.#.#######.###.###.#.#.###.#.#
#............O....#.....#.......#.....#...#.#.#.#...#...#.......#.....#.#.#.#.#...#...#.#.#.#.......#...#.....#.......#...#...#...#.#.#.....#
#.###.###.#.#O###.#####.#########.#####.#.#.###.###.#.###.#####.###.#.#.#.#.#.#######.#.#.#.#######.###.#.###.#.#####.#####.###.###.#.#####.#
#.#...#...#.#O..#.#.#...#.#.......#...#.#.#.....#...#...#...........#.#...#.#.......#.#...#.#.#.....#...#...#.#.#...#.......#...#...#...#...#
#.#.###.###.#O#.#.#.#.###.#.#######.###.#.#######.#####.#####.#.#.#.#######.#####.#.#.#####.#.#.#####.#####.###.#.#.#########.#####.###.###.#
#...#.#...#.#O#.#.#.#...#.#.#.......#...#.#.............#.......#...#.....#.......#.......#.#...#.........#.....#.#.....#.....#.....#.#...#.#
#####.#.###.#O#.#.#.###.#.#.###.###.#.###.#.#####################.###.###.#######.#######.#.#.#########.#.#######.#####.#.#####.###.#.###.#.#
#.#...#.#...#O#.#.#...#...#...#...#.#.#.#...#.....#.............#...#...#.#.......#...#.....#.........#.#.......#...#.#.#...#...#.#.#...#.#.#
#.#.#.#.#.###O###.#.#.#.#####.###.#.#.#.#####.#.#.#.#####.#####.#.#.###.#.#.#####.#.#.###############.###.###.#.###.#.#.###.#.###.#.###.#.#.#
#.#.#.#.#.#..O....#.#.#.#.....#...#.#...#.......#.#.......#...#.#.......#.#.......#.#...........#.......#.#...#...#.#.#.....#.#.......#.#.#.#
#.#.#.#.#.###O#.#####.#.#.#####.###.#.#.#.#####.#.#######.#.#.#.#.#######.#######.#.###########.#.#.###.###.#######.#.#######.#######.#.#.#.#
#.#.#.#.#....O#.......#.#.#.....#.....#.#.....#.#.......#.#.#.#.#.......#.#.......#.#.......#.#.#.#...#.#...#.......#.......#.......#.#.#.#.#
#.#.#.#.#####O#######.#.#.#####.#######.#.#.#.#######.###.#.###.#########.#.#######.#.#####.#.#.###.#.#.#.#.#.#######.#.###.#.#####.#.#.#.#.#
#...#...#....O#.....#...#.#...#.#...#...#.#.#.........#...#...#.#.....#.....#.......#.....#...#.....#.#...#.#.....#...#.#...#...#...#...#.#.#
#.#######.###O#.###.###.#.#.#.#.#.#.#.#####.#####.#####.#####.#.#.###.#.###.#.###########.###.#######.#.#######.#.###.#.#.###.###.#####.#.###
#.#.....#....O..#.#.#...#.#.#.#...#.........#...#.#...........#...#...#.....#.....#.......#.#...#...#.#.#.......#...#.#.#...#.#...#.....#...#
#.###.#.#####O###.#.#.###.#.#.#########.#####.#.###.#.###.###.#####.#####.#######.#.#######.###.#.#.#.#.#.#.###.###.#.#.###.#.#.###.#######.#
#...#.#.....#OOO..#...#.#...........#.#.#...#.#.....#...#.#...#...#.....#...#.....#.#.#.........#.#...#.#.#...#.....#.#...#.#...#.....#.....#
###.###.###.#.#O#######.###########.#.#.#.#.#.#######.#.#.#####.#.#####.#####.#####.#.#.#########.#.#.###.###.#.#.#.###.#.#.#.###.#####.###.#
#.#.....#.#.#.#OOOOO..#.....#.....#.#...#.#.#.........#.#.....#.#.....#...#...#.....#.#.#.....#...#.....#.#.#...#.#...#.#.#.#.#.#.#.....#...#
#.#######.#.#####.#O#.###.#.###.###.#.###.#.###.#.###.#.#####.#.#####.###.#.###.#.###.#.#.###.#.###.#.#.#.#.###.#####.#.#.#.#.#.#.#.#####.###
#.......#.#.....#.#O..#...#.....#...#...#.#.....#...#.#.......#...#.#...#.#.#...#...#.#.#.#...#...#.#.#.#...#.#.......#.#.#...#...#.#...#.#.#
###.###.#.#####.#.#O###.#########.#######.#####.###.#.#######.###.#.###.#.#.#.#####.#.#.#.#.###.#.#.#.#.###.#.#########.#.###.#####.#.#.#.#.#
#...#.#.#.....#...#OOO#.#...#...#.......#.#.......#...#...#...#.#.#.....#.#...#...#.#.....#.#...#.#.#.#.#...#.........#.#.#...#.....#.#...#.#
#.###.#.#.###########O#.#.#.#.#.#######.#.#.###########.###.###.#.###.###.#.###.#.#.#######.#.###.#.#.#.#.###.#######.###.#.###.#####.###.#.#
#.#...#.#.........#OOO#.#.#.#.#.......#.#.#.......#...#.....#...#...#...#.#.....#.#...#...#...#...#.#.#...#...#...#...#...#.#.#.#...#...#...#
#.###.#.#.#######.#O###.#.#.#.#######.#.#.#######.#.#.#.#####.#####.###.#.#######.#.#.#.#####.#.#.###.#.#.#.###.#.#.###.###.#.#.###.#.#.#.###
#...............#.#OOO#...#.#...#...#...#.#.....#.#.#...#.....#...#.#...#.......#.#.....#.....#.#.#...#...#.#.#.#.......#.#...#...#...#.#...#
#.#.###.#.#####.#.###O#####.###.#.#.#.###.#.###.#.#.#####.#####.#.#.#.###.#####.#.###.#.#.#####.###.#######.#.#.#########.###.###.###.#.#.#.#
#.#.....#.......#...#OOOOO#...#...#.#.....#.#...#...#.....#.....#...#.....#.#...#...#.#.#.#...#...#.#.......#.....#...#.........#...#.#.#...#
#.#.#######.#######.#####O#.#.#####.#.#####.#.#######.###.#.###############.#.#####.#.#.#.#.#.#.#.#.#.#.###########.#.#.###.#######.#.#.###.#
#.#...#...............#OOO..#.....#.#.#.....#.....#...#...#.#.....#.....#...#.#.#...#.#.#.#.#...#...#.#.#.....#.....#.#.....#.....#.#.....#.#
#.###.#.###.#.#########O#######.#.#.#.###.#######.#.#.###.#.#.###.#.#####.#.#.#.#.###.#.#.#.#######.###.#.###.#.###.#.#######.###.#.#.###.#.#
#...#.#.#...#.#OOOOO#OOO#.#.....#...#...#.#...#.#...#...#.#.#...#.#.......#.....#.#...#...#.............#.#.#.#.#.............#.#.#...#.....#
###.#.#.#.#.#.#O###O#O###.#.#######.###.#.#.#.#.#######.###.###.#.#####.#########.###.#.###.#######.#####.#.#.#.###############.#.#.#.#####.#
#...#.#.#.#.#.#O#.#OOO#...#.#...........#.#.#.....#...#...#.....#.#...#...#...........#...#...#.....#.....#.#.#.........#.......#.#.#.#...#.#
#.###.#.#.#.#.#O#.#####.#.#.#.###########.#.#####.#.#.###.#######.#.#.#####.#.###########.###.#.#.###.#####.#.#########.#####.###.###.#.#.###
#OOOOOOOOOOO..#OOOOOOO#...#...#.......#.#.#.....#...#...#.....#...#.#.........#...#.....#.#...#.#.#...#.....#.#.......#.....#...#...#...#...#
#O#########O#########O#.#######.#####.#.#.#####.#####.#######.#.###.#########.#.#.#####.#.#####.###.###.###.#.#.#####.###.#.#.#.###.#.#####.#
#O#........OOOOO..#OOO#...#.....#.......#.....#.............#.#...#.#.#.....#.#.#.....#.........#...#...#.#.#.#...#.....#.#.#.#.....#.#.....#
#O#.#######.###O###O#####.#.###.#############.###.#######.#.#.###.#.#.#.###.#.#.#####.#######.###.###.###.#.#.#.#.#####.#.#.#.#########.#####
#O#.#.........#OOO#OOOOO#...#.#.#...........#...#.....#.....#...#.#.#.#.#.#.#.#...#.....#.....#...#.#.#...#...#.#.#...#.#.#.#.....#.....#...#
#O#.###.#.#######O#####O#.###.#.#.#########.###.#####.#.###.###.#.#.#.#.#.#.###.#.#####.#####.#.###.#.###.#####.#.#.#.#.###.#####.#.#####.#.#
#O#...#.#.......#OOOOOOO......#.......#...#.....#.....#.#.#...#.#...#.#.#.#...#.#.....#.....#.#.#...#.........#.#...#.#...#...#.#.#...#...#.#
#O###.#.#####.#.#####.#######.#######.###.#########.###.#.#.###.#####.#.#.###.#.#####.#####.###.#.###########.#.#####.###.###.#.#.#.#.#.#####
#O....#.#...#.......#.....#.....#...#.....#.......#.#...#...#.........#.#.#...#.#.....#...#.....#...........#.......#.#.#.........#...#.....#
#O#######.#.#####.#.###.#.#.#####.#.#####.#.#####.###.###.#.#.#######.###.#.#####.#####.#########.#####.#.#.#######.#.#.#######.###.###.###.#
#O#.......#.......#.....#.......#.#.......#.#...#...#...#...#.........#...#.......#...#.......#.....#.....#.#.....#.#.#.............#.#.#.#.#
#O#.#######.###################.#.#.###.#.#.###.###.###.#########.#.#.#.#.#########.#.#.#.###.#.#####.#####.#.#.#.#.#.#.#.###########.#.#.#.#
#O#.......#.#.........#.......#...#...#.#...#...#.......#.........#...#...........#.#.#.#.#.....#.#...#.....#.#.#.#.....#.............#...#.#
#O###.###.###.#######.#.#############.#.#####.###.#######.#########.#.#.#.#######.###.#.#.###.#.#.#.###.#####.#.#.#####.###########.#.###.#.#
#OOO#...#.#...#...#...#.....#.......#.#...........#.....#.#.........#...#.#.....#...#.#.#...#.#.#.#...#.#.....#.#...#...#.....#...#.#...#.#.#
###O#####.#.#####.#.###.###.#.#####.#.###.#.#######.###.#.#.#############.#.###.###.#.#.#.#.###.#.###.###.#####.#####.#####.###.#.#.#.###.#.#
#.#OOOOO#.#.....#.#...#...#.#.#.....#...#...#.......#.#.#.#.....#.......#.....#.#...#.#.#.#.....#...#...#...#.#.............#...#.#.#.#...#.#
#.#####O#.#.#.#.#.###.#####.#.#.#######.#.###.###.#.#.#.#.#####.#.#.###.#.###.#.###.#.#.#.#######.#.###.###.#.#######.#######.###.###.#.###.#
#OOOOOOO#.#...#.....#.#...#...#.#...#...#...#.#.....#.....#...#.#.#...#...#.#.#...#...#.#.#.......#.#.#...#.#.......#...#...#.........#...#.#
#O#######.#########.#.#.#.###.#.#.#.#.###.###.#############.#.#.#.###.###.#.#.###.#.###.#.#.###.###.#.###.#.#.###.###.#.#.#.#.#.#########.#.#
#OOO#...............#...#...#.#...#.#.....#...#...........#.#...#...#...#.#.#.#.#.#.#...#...#...#.#.....#...#...#.#...#...#...#.#.........#.#
###O###############.#######.#.#####.#.#.###.###.#######.#.###.#########.#.#.#.#.#.###.###.#.#.###.#####.###.###.#.#.#####.#######.#####.###.#
#.#OOOOOOOOOOOOOOO#.#.....#.#.#.....#.#...#.....#.#...#.#...#.....#...#.#...#.#.#.....#.#.#.#...........#.......#.#.#.....#.......#...#.#...#
#.###############O#.#.###.#.#.#.#####.###.###.###.#.#.#####.#####.#.#.#.###.#.#.#######.#.#.#.#.#.#####.###.#####.#.#######.#######.#.#.#.#.#
#.......#...#....O#.#.#...#.#.#.....#.#.#.#.......#.#.......#...#...#.#...#.#.#.....#...#...#.#...#...#...#...#...#...#.......#...#.#.....#.#
#.#####.#.#.#.###O###.#.###.#.#####.#.#.#.#.###.###.#########.#######.#.#.###.#.###.#.#.###.#.###.#.#.###.#.#.#######.#.#######.#.#.#########
#.....#.#.#...#..OOO..#.#...#.......#.....#.#...#...#...............#.#.....#.#...#...#...#.#.#...#.#.#...#.#.#.......#.#.....#.#.#.........#
#.###.###.#####.###O###.#.#######.#.#.#.#####.###.#########.#####.#.#.#####.#.###.#######.#.#.#.###.#.###.###.#.#.#.###.#.###.#.#.#########.#
#...#.....#.......#OOO#.#.#.......#.#.#.....#...#.#.......#.....#.#.#.#...#.....#...#.......#.#.#...#...#.#...#.#...#...#...#.#.#.#.........#
###.#################O#.#.#.#######.#.#####.###.#.#.###.#.#####.#.###.#.#.#.###.###.#.#.#.###.#.#.#####.#.#.#.#.#.###.#####.#.#.#.#.#######.#
#...#.............#OOO#...#.#.....#.#...#.............#...#.....#.#...#.#.#...#.....#.#.......#.#.#.....#.#.#.#.#.#...#...#.#.#.#.#.#...#...#
#.###.###########.#O#######.#.###.#####.#######.#####.#.#########.#.###.#.#.#.#.#####.#####.#####.#.###.#.#.###.#.#.#####.#.#.#.#.#.#.#.#.###
#.#.........#OOO#.#O#...........#.....#.......#.....#.#...#...#...#...#.#...#.#...#...#.....#...#.#.#...#...#...#...#.....#.#...#...#.......#
#.#########.#O#O#.#O#.###############.###.###.###.#.#####.#.#.#.#####.#.#.###.###.#.###.#####.#.#.#.#.#######.###.#.#.#####.#.#####.#######.#
#...#.......#O#O#..O#.......#.........#.#.....#...........#.#.#.#.....#.#.#...#.#...#...#...#.#.......#.......#...#.........#.#...#.#...#.#.#
#.#.#.#######O#O###O#####.#.#.#######.#.#.#####.###########.#.#.#.#####.#.#.###.#####.#.#.###.#####.###.#############.#.#####.#.#.###.#.#.#.#
#...#...#OOOOO#OOO#O......#...#.#.....#.#...#...#...#.......#...#.#.....#.#.....#...#...#.#...#...#.#...............#.#.#.......#.#...#.#...#
#.#####.#O#####.#O#O###########.#.#####.###.#.###.#.#.#.###.#####.#.#####.###.#.#.#.#.###.#.###.###.#.#############.#.#.#.#######.#.###.#.###
#.......#OOO..#.#OOO#.#.........#.........#.#.#...#.#.#.#...#.....#.....#.....#...#.#.....#.#.......#.........#...#...#.#.......#...#...#.#.#
###########O###.#####.#.#######.#########.#.#.#####.#.#.###.#.#####.###.#.#########.#####.#.#####.#######.###.###.#####.#######.#####.###.#.#
#..OOO#..OOO..#...#.....#.#...#.....#...#.#.........#.#.....#...#...#...#...#.............#.....#.#...#.....#.....#.....#.............#.#...#
###O#O###O###.#.#.###.###.#.#.###.#.#.###.#####.#####.#####.#.#.#.###.#####.#.###.#.#####.#####.#.#.#.#.###.#####.#.###.###.#.#.#.#.#.#.###.#
#OOO#OOOOO#.#.#.#...#...#.#.#.....#...#...#.....#.....#...#...#.#...#.....#...#.....#.....#...#.#...#.#.#.........#...#...............#...#.#
#O#########.#.#####.###.#.#.###########.#####.#.#.#####.###.#.#.###.#####.#.#########.#####.#.#.#####.#.#####.#######.#####.###.#.#.#.#.###.#
#O........#.#.......#.#.#.#.....#...............#.#.....#...#.#...#...#.#.#.#...............#...#...#.......#.#...#...#...#.#...#.#.#.#...#.#
#O#######.#.#########.#.#.#####.#.#############.#.#.#.###.#######.###.#.#.###.#############.#####.###.#.###.#.#.#.#.###.###.#.#####.#.###.#.#
#O#.#.....#...#.........#...#...#.#...#.....#...#.#.#...#.......#...#...#...........#.....#.#.....#...#.#.#.#...#.#.#...#...#.......#...#.#.#
#O#.#.#####.#.#.#######.###.#.###.###.#.###.#####.#.#.#.#######.#.#.###.###########.#.###.#.#.###.#.###.#.#.#####.#.#.###.#####.#######.#.#.#
#OOO#.#...#.#...#.....#...#.#.....#...#.#.#...#...#...#...#...#...#...#.#.........#.#.#.#...#.#.#.#.#...#.#.....#...#.#...#.....#.......#.#.#
###O#.#.#.#######.###.###.#.#######.#.#.#.#.#.#.#######.#.#.#.###.###.#.#.#######.###.#.#####.#.#.#.###.#.#####.#####.#.###.#####.#.#.###.#.#
#OOO#.#.#...#.....#...#...#.......#.#.#...#.#...#.......#.#.....#.....#.#.#...#...#...#.....#.#...#...#.#.....#...#.....#...#.....#.#.#.....#
#O###.#.###.#.#####.#####.#.#####.#.#.###.#.#####.#######.#####.#######.#.###.#.###.###.#.#.#.#.#####.#.###.#.###.#.#####.###.#####.#.#.#####
#OOO#.#.#.........#.#...#...#.#...#.#...#.........#.#.....#.........#...#...#.......#...#.#...#...#...#...#.#...#.#.#.....#.#...#.#.#.....#.#
#O#O#.#.#.#####.#.#.#.#.#####.#.###.###.#####.#####.#.#####.#######.#####.#.#############.#####.###.#####.###.#.#.###.#####.###.#.#.#.###.#.#
#OOO#.#.......#.#...#.#.#.....#...........#.....#...#...#.#.....#.#.....#.#.....#.....#...#...#.#...#...#.....#.#.#...#.......#.#...#.#.#...#
###O#.#####.###.#####.#.#.#####.#####.#.###.#.###.#.###.#.#.###.#.#####.#.#####.#.###.#.###.###.#.###.#.#####.###.#.#######.###.#.###.#.###.#
#OOO#.#.....#...#.....#.#.............#.#...#.....#.#...#...#.#.#.....#.#.#.......#...#...#.....#.....#...#...#...#.#.......#...#.#...#.#...#
#O###.#.#####.###.#####.#.#############.#.#########.#.#####.#.#.###.#.#.###.#.###.#.#####.#####.#########.#####.#.#.#.#.###.#.#.#.#.###.#.###
#O#...#.#...#.........#.#.....#.....#...#.....#.....#.....#...#.#...#.#.#...#...#.#.#.....#...#.#.......#.....#.......#.....#.#.#...#.#...#.#
#O#.###.#.#.###########.#####.#.###.#.#######.#.#########.#####.#.#####.#.#####.###.#.#####.#.###.#.#.#######.#########.#####.#.#####.#.###.#
#O#.........#.........#...#...#...#.#.......#.#.......#...#.....#...#...#.#.........#.....#.#.....#.#.#.....#.....#.........#.#.......#.#...#
#O###########.#######.###.#######.#.#########.#####.#.#.###.#######.#.#.#.###########.###.#.#######.###.###.#####.#######.###.#.###.###.#.#.#
#OOOOO#.......#...#...........#...#.#...#...#...#.#.#.#.#...#.......#.#.......#.#.....#.#.#...#...#.....#.#.......#.....#.#...#...#.#...#.#.#
#####O#.#.#.###.#.#########.#.#.###.#.#.#.#.#.#.#.#.###.#.#.###.#.#.#.#.#####.#.#.#.#.#.#.###.#.#########.#########.###.###.###.#.#.#.###.#.#
#.#OOO#.#.#...#.#...#.....#.#.#.#...#.#...#...#.#.#.#...#.#.....#.#...#.....#.#.........#.....#.......#.............#...#...#...#.#.#...#.#.#
#.#O###.###.#.#.#.#.#.###.#.#.#.#.###.#.#####.#.#.#.#.#.#.#.###.###.#.#####.#.#####.#.#.#########.###.#####.#######.###.#.###.#.#.#.###.#.#.#
#OOO#.#.....#...#...#.#...#.#...#...#.#...#...#.#.#...#...#...#.#...#.......#...#...#...#.......#.#.......#...#...#...................#.#.#.#
#O###.###########.#.#.#.###.#####.#.#.###.#.#.#.#.#####.#.#.#.###.#.#.#########.###.#.#######.#.#.#######.#.###.#.###.#.#.#.###.#.#####.###.#
#O#..OOOOOOO....#.#.#.#.....#.....#.#...#.#.#.#.#.......#.#.#.....#.#.........#...#.#.....#...#.#.....#...#.#...#...#.#...#.#.....#...#.#...#
#O#.#O#####O#####.#.#.#######.###.#.###.#.#.#.#.#.#.###.#.#.#######.#.###########.#.#.#.#.#.###.#####.#.#####.###.#.#.#####.#.#####.#.#.#.###
#O#.#O#OOOOO#.....#.#.......#.....#...#...#.....#.#.#.#...#...#...#...#.....#...#.#.....#...#...#...#.#.#...........................#.......#
#O###O#O#####.#.###########.#####.###.###.###.#####.#.#.#####.#.#.#.###.###.#.#.#.#.#.#.#####.###.#.#.#.#.#####.#.#.#.#.#.#.#.#.#.#########.#
#OOOOO#O#...#.#.#...#.............#.....#.....#.....#.......#.#.#.....#...#...#.#...#.#...#...#...#...#.#...#...#.#...#.#...#.#.#...........#
#######O###.#.###.#.#.###.###.###.#.#########.###.#####.#.###.#.###.#.#.#.#####.###.#.###.#.###.#######.#.#.#.#.#######.#####.#.###.#.#####.#
#OOOOO#O#...#...#.#.#.#.#.....#.....#.......#...#.......#.#...#.....#.#.#.#...#.....#...#...#...#.#...#.#.#.#.#...#.....#...#.#...#.#.#...#.#
#O###O#O#.#.###.#.#.#.#.###.#.#.#.###.###.#####.#######.#.#.###.#.#.#.###.#.#######.#.#.#######.#.#.#.#.###.#.###.#.#####.#.#.###.###.#.###.#
#O..#OOO..#...#...#.......#...#.........#...............#.......#.#.............................#...#.......#...#.........#.#.........#.....#
#############################################################################################################################################
580
